{
    "backgroundIndex": 1,
    "musicIndex": 1,
    "map": [
        "._[4 ][4 ][4 ][4 ][4 ][4 ][4 ][4 ][4 ][4 ]_.",
        ".__.[3 ][3 ][3 ][3 ][3 ][3 ][3 ][3 ][3 ].__.",
        ".__.._[2 ][2 ][2 ][2 ][2 ][2 ][2 ][2 ]_..__.",
        ".__..__.[! ][! ][! ][! ][! ][! ][! ].__..__.",
        ".__..__.._[? ][? ][? ][? ][? ][? ]_..__..__.",
        ".__.[x ].__.[1 ][1 ][1 ][1 ][1 ].__.[x ].__.",
        ".__..__..__..__..__..__..__..__..__..__..__.",
        "._[0 ]_.._[0 ]_.._[0 ]_.._[0 ]_.._[0 ]_..__.",
        ".__.._[0 ]_.._[0 ]_.._[0 ]_.._[0 ]_.._[0 ]_.",
        ".__..__..__..__..__..__..__..__..__..__..__.",
        ".__.[x ][5 ][5 ][5 ][5 ][5 ][5 ][5 ][x ].__.",
        ".__..__..__..__..__..__..__..__..__..__..__.",
        ".__.[? ].__.[? ].__.[? ].__.[? ].__.[? ].__.",
        ".__..__..__..__..__..__..__..__..__..__..__.",
        ".__..__..__..__..__..__..__..__..__..__..__.",
        ".__..__..__..__..__..__..__..__..__..__..__.",
        ".__..__..__..__..__..__..__..__..__..__..__.",
        ".__..__..__..__..__..__..__..__..__..__..__.",
        ".__..__..__..__..__..__..__..__..__..__..__.",
        ".__..__..__..__..__..__..__..__..__..__..__.",
        ".__..__..__..__..__..__..__..__..__..__..__.",
        ".__..__..__..__..__..__..__..__..__..__..__.",
        ".__..__..__..__.._(======)_..__..__..__..__.",
        "()_..__..__..__..__..__..__..__..__..__.._()"
    ]
}