{
    "map": [
        "._[0 ][0 ][0 ][0 ][0 ][0 ][0 ][0 ][0 ][0 ]_.",
        ".__.[1 ][1 ][1 ][1 ][1 ][1 ][1 ][1 ][1 ].__.",
        ".__.._[2 ][2 ][2 ][2 ][2 ][2 ][2 ][2 ]_..__.",
        ".__..__.[0 ][0 ][0 ][0 ][0 ][0 ][0 ].__..__.",
        ".__..__.._[1 ][1 ][1 ][1 ][1 ][1 ]_..__..__.",
        ".__..__..__.[2 ][2 ][2 ][2 ][2 ].__..__..__.",
        ".__..__..__..__..__..__..__..__..__..__..__.",
        ".__..__..__..__..__..__..__..__..__..__..__.",
        ".__..__..__..__..__..__..__..__..__..__..__.",
        ".__..__..__..__..__..__..__..__..__..__..__.",
        ".__..__..__..__..__..__..__..__..__..__..__.",
        ".__..__..__..__..__..__..__..__..__..__..__.",
        ".__..__..__..__..__..__..__..__..__..__..__.",
        ".__..__..__..__..__..__..__..__..__..__..__.",
        ".__..__..__..__..__..__..__..__..__..__..__.",
        ".__..__..__..__..__..__..__..__..__..__..__.",
        ".__..__..__..__..__..__..__..__..__..__..__.",
        ".__..__..__..__..__..__..__..__..__..__..__.",
        ".__..__..__..__..__..__..__..__..__..__..__.",
        ".__..__..__..__..__..__..__..__..__..__..__.",
        ".__..__..__..__..__..__..__..__..__..__..__.",
        ".__..__..__..__..__..__..__..__..__..__..__.",
        ".__..__..__..__..__..__..__..__..__..__..__.",
        ".__..__..__..__..__..__..__..__..__..__..__.",
        ".__..__..__.._(==========)_..__..__..__..__.",
        "()_..__..__..__..__..__..__..__..__..__.._()"
    ]
}